#############################
#                           #
# ###########  ############ #
# #         #  #          # #
# ######    #  #   ######## #
# #                       # #
# ######    #  #   ######## #
# #         #  #          # #
# ######    #  #   ######## #
# #                       # #
# ######    #  #   ######## #
# #         #  #          # #
# ###########  ############ #
#                           #
#############################

##########
#*  *  * #
###   #  #
#    #   #
#    #   #
#    #   #
#    #   #
# *  #   #
#    #   #
#*       #
##########
